Reference;Afsender;Beløb;Løbende_saldo;Statuskonto
Cap RW-250211 29 ACONTO;2000;-3304,32;-33197552,81;90540000
Cap RG-250211 29 ACONTO;05479;-6400,00;-33194248,49;90540000
Cap Rekvireret udbetalin;2000;-79,74;-33187848,49;90540000
Cap Overførsel                     Meddelnr. 03978131125041;PROTECTOR FORSIKRING DANMARK;1763932,40;-33187768,75;90540000
Cap Overførsel                     Meddelnr. 03978131025041;PROTECTOR FORSIKRING DANMARK;2367,50;-34951701,15;90540000
Cap NKS-KY;05395;-640,00;-34954068,65;90540000
Cap NKS-KY;GIRO-CARD;-546,31;-34953428,65;90540000
Cap NKS-KY;GIRO-CARD;-214,71;-34952882,34;90540000
Cap NKS-KY;03724;-500,00;-34952667,63;90540000
Cap NKS-KY;06110;-3971,00;-34952167,63;90540000
Cap NKS-KY;GIRO-CARD;-92,71;-34948196,63;90540000
Cap Aarhus Kommune                 Meddelnr. 07005565525038;AARHUS KOMMUNE;112239,00;-34948103,92;90540000
NKS-KY;;-21350,94;-35060342,92;90540000
NKS-KY;;-4000,00;-35038991,98;90540000
NKS-KY;;-2609,52;-35034991,98;90540000
NKS-KY;;-208052,77;-35032382,46;90540000
NKS-KY;;-1396,64;-34824329,69;90540000
NKS-KP;;-1708,50;-34822933,05;90540000
Leverandørudbetaling;;-1473784,01;-34821224,55;90540000
Leverandørudbetaling;;-765234,79;-33347440,54;90540000
Gebyr udland 3504114765GEB   NCHG;;-4,00;-32582205,75;90540000
Gebyr udland 3504112292GEB   NCHG;;-4,00;-32582201,75;90540000
Indbetalingskort K 89182816-07.02;;349808,96;-32582197,75;90540000
Indbetalingskort K 86446707-07.02;;3113,48;-32932006,71;90540000
Indbetalingskort K 86136228-07.02;;5100,00;-32935120,19;90540000
Indbetalingskort K 84788767-07.02;;7833313,66;-32940220,19;90540000
Indbetalingskort K 82075348-07.02;;1000,00;-40773533,85;90540000
Bs betaling KON konto 0970205918;;255150,09;-40774533,85;90540000
Bs betaling KON konto 0970205918;;-4506,09;-41029683,94;90540000
Bgs Pension Peter090361u           dl. af BS;RANDERS KOMMUNE;7505,00;-41025177,85;90540000
Bgs Pens. Tanja 061074.u           dl af BS;RANDERS KOMMUNE;2500,00;-41032682,85;90540000
Bgs Pens. Rolf 060387 ud           l. af BS;RANDERS KOMMUNE;5560,00;-41035182,85;90540000
Bgs Pens. Debbie Bak 210           989 udl. af BS;RANDERS KOMMUNE;3880,00;-41040742,85;90540000
Bgs Pens. Chris 070288 u           dl. af BS;RANDERS KOMMUNE;4371,00;-41044622,85;90540000
Bgs Pens. Albrecht 22049           4 udl .af BS;RANDERS KOMMUNE;14265,00;-41048993,85;90540000
Dankort-salg 09.02 5247969 691706;;601,00;-41063258,85;90540000
Dankort-salg 09.02 4922735 208545;;7,00;-41063859,85;90540000
Dankort-salg 09.02 4922735 208545;;120,00;-41063866,85;90540000
Dankort-salg 09.02 4922735 208232;;58,00;-41063986,85;90540000
Dankort-salg 09.02 4922735 208168;;17,00;-41064044,85;90540000
Dankort-salg 09.02 4922735 208146;;6,00;-41064061,85;90540000
Dankort-salg 09.02 4922735 208109;;120,00;-41064067,85;90540000
Dankort-salg 09.02 4922735 208074;;240,00;-41064187,85;90540000
Dankort-salg 09.02 4862899 519250;;3850,00;-41064427,85;90540000
Dankort-salg 09.02 3796930 038850;;488,00;-41068277,85;90540000
Dankort-salg 09.02 3796914 872350;;5022,50;-41068765,85;90540000
Dankort-salg 09.02 3796914 872250;;1576,00;-41073788,35;90540000
Dankort-salg 09.02 3796892 671350;;258,00;-41075364,35;90540000
Dankort-salg 09.02 3796884 620050;;378,00;-41075622,35;90540000
Dankort-salg 09.02 3796795 277050;;108,00;-41076000,35;90540000
Dankort-salg 09.02 2471043 092150;;665,50;-41076108,35;90540000
Dankort-salg 08.02 5541069 258950;;100,00;-41076773,85;90540000
Dankort-salg 08.02 5247969 550580;;33,75;-41076873,85;90540000
Dankort-salg 08.02 4922735 208921;;172,00;-41076907,60;90540000
Dankort-salg 08.02 4922735 208920;;2,00;-41077079,60;90540000
Dankort-salg 08.02 4922735 208614;;2258,00;-41077081,60;90540000
Dankort-salg 08.02 4922735 208545;;310,00;-41079339,60;90540000
Dankort-salg 08.02 4922735 208542;;120,00;-41079649,60;90540000
Dankort-salg 08.02 4922735 208542;;1007,00;-41079769,60;90540000
Dankort-salg 08.02 4922735 208388;;172,00;-41080776,60;90540000
Dankort-salg 08.02 4922735 208363;;576,00;-41080948,60;90540000
Dankort-salg 08.02 4922735 208278;;27,00;-41081524,60;90540000
Dankort-salg 08.02 4922735 208243;;211,00;-41081551,60;90540000
Dankort-salg 08.02 4922735 208233;;40,00;-41081762,60;90540000
Dankort-salg 08.02 4922735 208232;;89,00;-41081802,60;90540000
Dankort-salg 08.02 4922735 208228;;65,00;-41081891,60;90540000
Dankort-salg 08.02 4922735 208202;;95,00;-41081956,60;90540000
Dankort-salg 08.02 4922735 208196;;252,00;-41082051,60;90540000
Dankort-salg 08.02 4922735 208168;;111,00;-41082303,60;90540000
Dankort-salg 08.02 4922735 208167;;120,00;-41082414,60;90540000
Dankort-salg 08.02 4922735 208165;;15,00;-41082534,60;90540000
Dankort-salg 08.02 4922735 208146;;120,00;-41082549,60;90540000
Dankort-salg 08.02 4922735 208146;;125,00;-41082669,60;90540000
Dankort-salg 08.02 4922735 208140;;171,00;-41082794,60;90540000
Dankort-salg 08.02 4922735 208135;;166,00;-41082965,60;90540000
Dankort-salg 08.02 4922735 208109;;36,00;-41083131,60;90540000
Dankort-salg 08.02 4922735 208074;;120,00;-41083167,60;90540000
Dankort-salg 08.02 4922735 208074;;660,00;-41083287,60;90540000
Dankort-salg 08.02 4922735 208065;;700,00;-41083947,60;90540000
Dankort-salg 08.02 4862899 082550;;2570,00;-41084647,60;90540000
Dankort-salg 08.02 3796930 038850;;522,00;-41087217,60;90540000
Dankort-salg 08.02 3796914 872250;;2757,00;-41087739,60;90540000
Dankort-salg 08.02 3796892 671150;;124,00;-41090496,60;90540000
Dankort-salg 08.02 3796884 620050;;221,00;-41090620,60;90540000
Dankort-salg 08.02 3796795 277050;;84,00;-41090841,60;90540000
Dankort-salg 08.02 2471043 092149;;1686,00;-41090925,60;90540000
Dankort-salg 07.02 7221290 725750;;805,00;-41092611,60;90540000
Dankort-salg 07.02 6256651 93IHPD;;1034,00;-41093416,60;90540000
Dankort-salg 07.02 6256651 60YJG2;;1034,00;-41094450,60;90540000
Dankort-salg 07.02 6256651 6D90HK;;1034,00;-41095484,60;90540000
Dankort-salg 07.02 6256651 532764;;290,00;-41096518,60;90540000
Dankort-salg 07.02 6256651 455747;;322,00;-41096808,60;90540000
Dankort-salg 07.02 6256651 22LPNI;;290,00;-41097130,60;90540000
Dankort-salg 07.02 6256651 2GF155;;1034,00;-41097420,60;90540000
Dankort-salg 07.02 6256651 1PK8R3;;322,00;-41098454,60;90540000
Dankort-salg 07.02 6256651 0DRTB3;;1034,00;-41098776,60;90540000
Dankort-salg 07.02 6256651 Z5W245;;1034,00;-41099810,60;90540000
Dankort-salg 07.02 6256651 X74XZJ;;1034,00;-41100844,60;90540000
Dankort-salg 07.02 6256651 X5HM8W;;290,00;-41101878,60;90540000
Dankort-salg 07.02 6256651 O5H18K;;522,00;-41102168,60;90540000
Dankort-salg 07.02 6256651 N4SR40;;322,00;-41102690,60;90540000
Dankort-salg 07.02 6256651 MMK7QF;;330,00;-41103012,60;90540000
Dankort-salg 07.02 6256651 KLZ5H5;;1034,00;-41103342,60;90540000
Dankort-salg 07.02 6256651 H7U387;;1034,00;-41104376,60;90540000
Dankort-salg 07.02 6256651 BD16IE;;322,00;-41105410,60;90540000
Dankort-salg 07.02 6201830 314650;;1392,00;-41105732,60;90540000
Dankort-salg 07.02 6175937 004112;;2600,00;-41107124,60;90540000
Dankort-salg 07.02 6175937 004111;;2600,00;-41109724,60;90540000
Dankort-salg 07.02 6175937 004110;;11000,00;-41112324,60;90540000
Dankort-salg 07.02 5991390 211750;;759,00;-41123324,60;90540000
Dankort-salg 07.02 5891507 276550;;45,00;-41124083,60;90540000
Dankort-salg 07.02 5891507 276450;;330,00;-41124128,60;90540000
Dankort-salg 07.02 5887356 164150;;163,00;-41124458,60;90540000
Dankort-salg 07.02 5846102 812550;;2734,00;-41124621,60;90540000
Dankort-salg 07.02 5541069 258850;;400,00;-41127355,60;90540000
Dankort-salg 07.02 4922735 208920;;347,00;-41127755,60;90540000
Dankort-salg 07.02 4922735 208920;;120,00;-41128102,60;90540000
Dankort-salg 07.02 4922735 208614;;514,00;-41128222,60;90540000
Dankort-salg 07.02 4922735 208545;;407,00;-41128736,60;90540000
Dankort-salg 07.02 4922735 208542;;400,00;-41129143,60;90540000
Dankort-salg 07.02 4922735 208388;;331,00;-41129543,60;90540000
Dankort-salg 07.02 4922735 208363;;105,00;-41129874,60;90540000
Dankort-salg 07.02 4922735 208363;;1576,00;-41129979,60;90540000
Dankort-salg 07.02 4922735 208278;;17,00;-41131555,60;90540000
Dankort-salg 07.02 4922735 208243;;166,00;-41131572,60;90540000
Dankort-salg 07.02 4922735 208233;;23,00;-41131738,60;90540000
Dankort-salg 07.02 4922735 208232;;133,00;-41131761,60;90540000
Dankort-salg 07.02 4922735 208228;;120,00;-41131894,60;90540000
Dankort-salg 07.02 4922735 208202;;63,00;-41132014,60;90540000
Dankort-salg 07.02 4922735 208196;;74,00;-41132077,60;90540000
Dankort-salg 07.02 4922735 208167;;120,00;-41132151,60;90540000
Dankort-salg 07.02 4922735 208167;;281,00;-41132271,60;90540000
Dankort-salg 07.02 4922735 208165;;29,00;-41132552,60;90540000
Dankort-salg 07.02 4922735 208146;;221,00;-41132581,60;90540000
Dankort-salg 07.02 4922735 208140;;235,00;-41132802,60;90540000
Dankort-salg 07.02 4922735 208135;;260,00;-41133037,60;90540000
Dankort-salg 07.02 4922735 208109;;60,00;-41133297,60;90540000
Dankort-salg 07.02 4922735 208074;;487,00;-41133357,60;90540000
Dankort-salg 07.02 4922735 208065;;647,00;-41133844,60;90540000
Dankort-salg 07.02 4862899 082450;;1540,00;-41134491,60;90540000
Dankort-salg 07.02 4771850 541250;;636,80;-41136031,60;90540000
Dankort-salg 07.02 4430778 983050;;1200,00;-41136668,40;90540000
Dankort-salg 07.02 4430778 983050;;240,00;-41137868,40;90540000
Dankort-salg 07.02 3796930 038850;;505,00;-41138108,40;90540000
Dankort-salg 07.02 3796914 872250;;80,00;-41138613,40;90540000
Dankort-salg 07.02 3796914 872150;;932,50;-41138693,40;90540000
Dankort-salg 07.02 3796892 671150;;384,00;-41139625,90;90540000
Dankort-salg 07.02 3796884 619950;;323,00;-41140009,90;90540000
Dankort-salg 07.02 3796817 778050;;454,00;-41140332,90;90540000
Dankort-salg 07.02 3796795 277050;;106,00;-41140786,90;90540000
Dankort-salg 07.02 3796671 704450;;529,00;-41140892,90;90540000
Dankort-salg 07.02 3796663 982450;;90,00;-41141421,90;90540000
Dankort-salg 07.02 2471043 092148;;572,00;-41141511,90;90540000
Dankort-salg 07.02 1992317 325350;;45,00;-41142083,90;90540000
Overførsel 4000000000010902259;VIPPS MOBILEPAY FILIAL AF;22546,66;-41142128,90;90540000
Overførsel 2020498350010902250;VIPPS MOBILEPAY FILIAL AF;385,00;-41199336,28;90540000
Overførsel 2020314620010902255;VIPPS MOBILEPAY FILIAL AF;130,00;-41200676,28;90540000
Overførsel 2020219860010902259;VIPPS MOBILEPAY FILIAL AF;34,50;-41201434,78;90540000
Overførsel 2020190910010902257;VIPPS MOBILEPAY FILIAL AF;73,00;-41201611,28;90540000
Overførsel 2008082310010902259;VIPPS MOBILEPAY FILIAL AF;5000,00;-41203640,28;90540000
Overførsel 2007785490010902257;VIPPS MOBILEPAY FILIAL AF;5575,00;-41209415,28;90540000
Overførsel 2005473320010902259;VIPPS MOBILEPAY FILIAL AF;50,00;-41217116,78;90540000
Overførsel 2004212550010902252;VIPPS MOBILEPAY FILIAL AF;40,00;-41217821,78;90540000
Overførsel 4000000000010802252;VIPPS MOBILEPAY FILIAL AF;9701,38;-41164675,56;90540000
Overførsel 2020498350010802253;VIPPS MOBILEPAY FILIAL AF;306,00;-41199721,28;90540000
Overførsel 2020219860010802252;VIPPS MOBILEPAY FILIAL AF;19,00;-41201469,28;90540000
Overførsel 2020190910010802250;VIPPS MOBILEPAY FILIAL AF;76,00;-41201684,28;90540000
Overførsel 2007978980010802250;VIPPS MOBILEPAY FILIAL AF;375,00;-41208665,28;90540000
Overførsel 2007583430010802250;VIPPS MOBILEPAY FILIAL AF;600,00;-41214990,28;90540000
Overførsel 2007557890010802253;VIPPS MOBILEPAY FILIAL AF;15,00;-41215590,28;90540000
Overførsel 2007361180010802256;VIPPS MOBILEPAY FILIAL AF;252,00;-41215705,28;90540000
Overførsel 2005827710010802256;VIPPS MOBILEPAY FILIAL AF;45,00;-41216943,78;90540000
Overførsel 2005800750010802259;VIPPS MOBILEPAY FILIAL AF;3,00;-41217043,78;90540000
Overførsel 2005751470010802251;VIPPS MOBILEPAY FILIAL AF;70,00;-41217046,78;90540000
Overførsel 2005438250010802257;VIPPS MOBILEPAY FILIAL AF;14,00;-41217492,78;90540000
Overførsel 4000000000010702255;VIPPS MOBILEPAY FILIAL AF;24959,34;-41174376,94;90540000
Overførsel 2020498350010702256;VIPPS MOBILEPAY FILIAL AF;558,00;-41200027,28;90540000
Overførsel 2020471040010702253;VIPPS MOBILEPAY FILIAL AF;91,00;-41200585,28;90540000
Overførsel 2020314620010702251;VIPPS MOBILEPAY FILIAL AF;187,50;-41200806,28;90540000
Overførsel 2020249660010702250;VIPPS MOBILEPAY FILIAL AF;441,00;-41200993,78;90540000
Overførsel 2020219860010702255;VIPPS MOBILEPAY FILIAL AF;123,00;-41201488,28;90540000
Overførsel 2020190910010702253;VIPPS MOBILEPAY FILIAL AF;206,00;-41201760,28;90540000
Overførsel 2020094080010702250;VIPPS MOBILEPAY FILIAL AF;300,00;-41201966,28;90540000
Overførsel 2020001320010702259;VIPPS MOBILEPAY FILIAL AF;54,00;-41202266,28;90540000
Overførsel 2009714140010702255;VIPPS MOBILEPAY FILIAL AF;750,00;-41202320,28;90540000
Overførsel 2009351340010702256;VIPPS MOBILEPAY FILIAL AF;10,00;-41203070,28;90540000
Overførsel 2008661100010702255;VIPPS MOBILEPAY FILIAL AF;49,00;-41203080,28;90540000
Overførsel 2008446080010702257;VIPPS MOBILEPAY FILIAL AF;40,00;-41203129,28;90540000
Overførsel 2008169120010702258;VIPPS MOBILEPAY FILIAL AF;471,00;-41203169,28;90540000
Overførsel 2008082310010702255;VIPPS MOBILEPAY FILIAL AF;25,00;-41208640,28;90540000
Overførsel 2007978980010702253;VIPPS MOBILEPAY FILIAL AF;375,00;-41209040,28;90540000
Overførsel 2007429540010702252;VIPPS MOBILEPAY FILIAL AF;100,00;-41215605,28;90540000
Overførsel 2007260820010702254;VIPPS MOBILEPAY FILIAL AF;175,00;-41215957,28;90540000
Overførsel 2007134000010702252;VIPPS MOBILEPAY FILIAL AF;345,00;-41216132,28;90540000
Overførsel 2006169460010702253;VIPPS MOBILEPAY FILIAL AF;68,50;-41216477,28;90540000
Overførsel 2006019860010702259;VIPPS MOBILEPAY FILIAL AF;342,00;-41216545,78;90540000
Overførsel 2005991510010702259;VIPPS MOBILEPAY FILIAL AF;56,00;-41216887,78;90540000
Overførsel 2005827710010702259;VIPPS MOBILEPAY FILIAL AF;55,00;-41216988,78;90540000
Overførsel 2005473320010702255;VIPPS MOBILEPAY FILIAL AF;326,00;-41217166,78;90540000
Overførsel 2004720010010702251;VIPPS MOBILEPAY FILIAL AF;315,00;-41217506,78;90540000
Overførsel 2001330680010902256;VIPPS MOBILEPAY FILIAL AF;108,00;-41218183,78;90540000
Overførsel N54102770145;NETS DENMARK A/S;3720,00;-41221214,72;90540000
Overførsel N36549770379;NETS DENMARK A/S;60966,76;-41224934,72;90540000
Overførsel N27026770236;NETS DENMARK A/S;8041,05;-41285901,48;90540000
Overførsel                         Meddelnr. 02409658525039;S/I Randers Idrætshaller;168779,50;-41293942,53;90540000
Overførsel                         Meddelnr. 02406923625039;SKATTEFORVALTNINGEN;10711,00;-41462722,03;90540000
Overførsel                         Meddelnr. 02406415725039;GENTOFTE KOMMUNE;52676,59;-41473433,03;90540000
Overførsel                         Meddelnr. 02406277225039;SKATTEFORVALTNINGEN;1535,00;-41526109,62;90540000
Overførsel                         Meddelnr. 02406277125039;SKATTEFORVALTNINGEN;28844,00;-41527644,62;90540000
Overførsel                         Meddelnr. 02406214525039;SKATTEFORVALTNINGEN;1977,00;-41556488,62;90540000
2601832588                         Meddelnr. 02408079225039;LEJERBO;150,00;-41558465,62;90540000
1803701993                         Meddelnr. 02408077625039;LEJERBO;150,00;-41558615,62;90540000
1512842182                         Meddelnr. 02408079325039;LEJERBO;100,00;-41558765,62;90540000
VEU-Godtg 3112761399               Meddelnr. 02406309725039;ARB.GIVERNES UDDANNELSESBIDRAG;1952,20;-41558865,62;90540000
VEU-Godtg 2307950491               Meddelnr. 02406309625039;ARB.GIVERNES UDDANNELSESBIDRAG;1952,20;-41560817,82;90540000
VEU-Befor 3112761399               Meddelnr. 02406290125039;ARB.GIVERNES UDDANNELSESBIDRAG;124,94;-41562770,02;90540000
VEU-Befor 2307950491               Meddelnr. 02406290025039;ARB.GIVERNES UDDANNELSESBIDRAG;57,62;-41562894,96;90540000
Udbetaling Danmark                 Meddelnr. 02410245725039;UDBETALING DANMARK;20829,75;-41562952,58;90540000
Udbetaling Danmark                 Meddelnr. 02410244425039;UDBETALING DANMARK;16840,00;-41583782,33;90540000
Udbetaling Danmark                 Meddelnr. 02410241425039;UDBETALING DANMARK;22671,00;-41600622,33;90540000
Udbetaling Danmark                 Meddelnr. 02410240525039;UDBETALING DANMARK;7925,00;-41623293,33;90540000
Udbetaling Danmark                 Meddelnr. 02410239825039;UDBETALING DANMARK;12335,02;-41631218,33;90540000
Udbetaling Danmark                 Meddelnr. 02410236325039;UDBETALING DANMARK;3747,62;-41643553,35;90540000
Udbetaling Danmark                 Meddelnr. 02410232325039;UDBETALING DANMARK;21918,63;-41647300,97;90540000
Udbetaling Danmark                 Meddelnr. 02410226425039;UDBETALING DANMARK;22671,00;-41669219,60;90540000
Udbetaling Danmark                 Meddelnr. 02410225525039;UDBETALING DANMARK;20690,00;-41691890,60;90540000
Udbetaling Danmark                 Meddelnr. 02410225325039;UDBETALING DANMARK;15910,53;-41712580,60;90540000
Udbetaling Danmark                 Meddelnr. 02410223625039;UDBETALING DANMARK;12046,77;-41728491,13;90540000
Udbetaling Danmark                 Meddelnr. 02410223225039;UDBETALING DANMARK;39086,82;-41740537,90;90540000
Udbetaling Danmark                 Meddelnr. 02410222825039;UDBETALING DANMARK;6934,00;-41779624,72;90540000
Udbetaling Danmark                 Meddelnr. 02410221625039;UDBETALING DANMARK;22671,00;-41786558,72;90540000
Udbetaling Danmark                 Meddelnr. 02410219025039;UDBETALING DANMARK;21444,85;-41809229,72;90540000
Udbetaling Danmark                 Meddelnr. 02410217325039;UDBETALING DANMARK;43661,05;-41830674,57;90540000
Udbetaling Danmark                 Meddelnr. 02410216825039;UDBETALING DANMARK;22671,00;-41874335,62;90540000
Udbetaling Danmark                 Meddelnr. 02410216625039;UDBETALING DANMARK;27682,86;-41897006,62;90540000
Udbetaling Danmark                 Meddelnr. 02410215425039;UDBETALING DANMARK;20218,66;-41924689,48;90540000
Udbetaling Danmark                 Meddelnr. 02410215025039;UDBETALING DANMARK;2473,32;-41944908,14;90540000
Udbetaling Danmark                 Meddelnr. 02410214425039;UDBETALING DANMARK;7925,00;-41947381,46;90540000
Udbetaling Danmark                 Meddelnr. 02410212925039;UDBETALING DANMARK;75546,21;-41955306,46;90540000
Udbetaling Danmark                 Meddelnr. 02410212625039;UDBETALING DANMARK;18380,41;-42030852,67;90540000
Udbetaling Danmark                 Meddelnr. 02410211825039;UDBETALING DANMARK;68013,00;-42049233,08;90540000
Udbetaling Danmark                 Meddelnr. 02410211025039;UDBETALING DANMARK;40389,00;-42117246,08;90540000
Udbetaling Danmark                 Meddelnr. 02410210825039;UDBETALING DANMARK;35185,20;-42157635,08;90540000
Udbetaling Danmark                 Meddelnr. 02410209725039;UDBETALING DANMARK;20218,66;-42192820,28;90540000
Udbetaling Danmark                 Meddelnr. 02410207725039;UDBETALING DANMARK;2811,22;-42213038,94;90540000
Udbetaling Danmark                 Meddelnr. 02410207325039;UDBETALING DANMARK;18380,41;-42215850,16;90540000
Udbetaling Danmark                 Meddelnr. 02410204525039;UDBETALING DANMARK;20218,66;-42234230,57;90540000
Udbetaling Danmark                 Meddelnr. 02410203325039;UDBETALING DANMARK;45342,00;-42254449,23;90540000
Udbetaling Danmark                 Meddelnr. 02410198825039;UDBETALING DANMARK;24711,42;-42299791,23;90540000
Udbetaling Danmark                 Meddelnr. 02410198425039;UDBETALING DANMARK;19607,60;-42324502,65;90540000
Udbetaling Danmark                 Meddelnr. 02410197425039;UDBETALING DANMARK;22671,00;-42344110,25;90540000
Udbetaling Danmark                 Meddelnr. 02410194025039;UDBETALING DANMARK;20218,66;-42366781,25;90540000
Udbetaling Danmark                 Meddelnr. 02410192325039;UDBETALING DANMARK;300097,36;-42386999,91;90540000
Udbetaling Danmark                 Meddelnr. 02410191825039;UDBETALING DANMARK;22671,00;-42687097,27;90540000
Udbetaling Danmark                 Meddelnr. 02410190925039;UDBETALING DANMARK;62497,30;-42709768,27;90540000
Udbetaling Danmark                 Meddelnr. 02410190325039;UDBETALING DANMARK;22671,00;-42772265,57;90540000
Udbetaling Danmark                 Meddelnr. 02410189825039;UDBETALING DANMARK;20218,66;-42794936,57;90540000
Udbetaling Danmark                 Meddelnr. 02410189425039;UDBETALING DANMARK;7919,69;-42815155,23;90540000
Udbetaling Danmark                 Meddelnr. 02410189125039;UDBETALING DANMARK;22671,00;-42823074,92;90540000
Udbetaling Danmark                 Meddelnr. 02410187725039;UDBETALING DANMARK;85167,26;-42845745,92;90540000
Udbetaling Danmark                 Meddelnr. 02410187625039;UDBETALING DANMARK;14859,00;-42930913,18;90540000
Udbetaling Danmark                 Meddelnr. 02410184625039;UDBETALING DANMARK;22671,00;-42945772,18;90540000
Udbetaling Danmark                 Meddelnr. 02410184525039;UDBETALING DANMARK;20218,66;-42968443,18;90540000
Udbetaling Danmark                 Meddelnr. 02410183025039;UDBETALING DANMARK;31244,13;-42988661,84;90540000
Udbetaling Danmark                 Meddelnr. 02410182425039;UDBETALING DANMARK;19607,60;-43019905,97;90540000
Udbetaling Danmark                 Meddelnr. 02410181825039;UDBETALING DANMARK;41051,41;-43039513,57;90540000
Udbetaling Danmark                 Meddelnr. 02410180125039;UDBETALING DANMARK;21138,78;-43080564,98;90540000
Udbetaling Danmark                 Meddelnr. 02410179025039;UDBETALING DANMARK;53267,00;-43101703,76;90540000
Udbetaling Danmark                 Meddelnr. 02410178625039;UDBETALING DANMARK;18380,41;-43154970,76;90540000
Udbetaling Danmark                 Meddelnr. 02410177725039;UDBETALING DANMARK;39643,25;-43173351,17;90540000
Udbetaling Danmark                 Meddelnr. 02410177125039;UDBETALING DANMARK;20829,75;-43212994,42;90540000
Udbetaling Danmark                 Meddelnr. 02410175725039;UDBETALING DANMARK;42278,60;-43233824,17;90540000
Udbetaling Danmark                 Meddelnr. 02410175425039;UDBETALING DANMARK;20218,66;-43276102,77;90540000
Udbetaling Danmark                 Meddelnr. 02410174525039;UDBETALING DANMARK;20218,66;-43296321,43;90540000
Udbetaling Danmark                 Meddelnr. 02410173125039;UDBETALING DANMARK;22671,00;-43316540,09;90540000
Udbetaling Danmark                 Meddelnr. 02410171125039;UDBETALING DANMARK;12878,00;-43339211,09;90540000
Udbetaling Danmark                 Meddelnr. 02410170925039;UDBETALING DANMARK;22671,00;-43352089,09;90540000
Udbetaling Danmark                 Meddelnr. 02410170125039;UDBETALING DANMARK;21680,00;-43374760,09;90540000
Udbetaling Danmark                 Meddelnr. 02410169725039;UDBETALING DANMARK;19607,60;-43396440,09;90540000
Udbetaling Danmark                 Meddelnr. 02410169425039;UDBETALING DANMARK;2972,00;-43416047,69;90540000
Udbetaling Danmark                 Meddelnr. 02410168125039;UDBETALING DANMARK;22671,00;-43419019,69;90540000
Udbetaling Danmark                 Meddelnr. 02410166625039;UDBETALING DANMARK;44115,85;-43441690,69;90540000
Udbetaling Danmark                 Meddelnr. 02410162525039;UDBETALING DANMARK;22671,00;-43485806,54;90540000
Udbetaling Danmark                 Meddelnr. 02405628625039;UDBETALING DANMARK;16972,25;-43508477,54;90540000
Udbetaling Danmark                 Meddelnr. 02405627425039;UDBETALING DANMARK;110421,00;-43525449,79;90540000
Udbetaling Danmark                 Meddelnr. 02405626425039;UDBETALING DANMARK;51060,00;-43635870,79;90540000
Udbetaling Danmark                 Meddelnr. 02405624625039;UDBETALING DANMARK;32944,15;-43686930,79;90540000
Udbetaling Danmark                 Meddelnr. 02405623125039;UDBETALING DANMARK;20218,66;-43719874,94;90540000
Udbetaling Danmark                 Meddelnr. 02405623025039;UDBETALING DANMARK;18380,41;-43740093,60;90540000
Udbetaling Danmark                 Meddelnr. 02405622025039;UDBETALING DANMARK;57861,57;-43758474,01;90540000
REGS.2025-0017-1                   Meddelnr. 02405721325039;SLOTS- OG KULTURSTYRELSEN;378549,75;-43816335,58;90540000
Prins Christiansgade;Cepheus Ejendomme A/S;4497,00;-44194885,33;90540000
Overførsel                         Meddelnr. 02409960825039;Silkeborg Kommune;475000,00;-44199382,33;90540000
Nyvej 11 A, 1. th.;Cepheus Ejendomme I/S;4497,00;-44674382,33;90540000
Falck Assistance A/S               Meddelnr. 02406584925039;FALCK DANMARK A/S;5935,38;-44678879,33;90540000
Ekstra sæk Januar 20;OPEN EXPERIENCE APS;2828,00;-44684814,71;90540000
Bredstrupsgade 14, s;Cepheus Ejendomme I/S;4497,00;-44687642,71;90540000
j.nr. 141284 1472;Boligselskabet af 2014;17154,00;-44692139,71;90540000
Udenl. overf. 3504114765      NTRF;DFW Europe B.V.;-9802,32;-44709293,71;90540000
Udenl. overf. 3504112292      NTRF;Elektrobode;-910,74;-44699491,39;90540000
Overførsel 2004212550010802255;VIPPS MOBILEPAY FILIAL AF;80,00;-41217861,78;90540000
Overførsel 2002936220010802258;VIPPS MOBILEPAY FILIAL AF;150,00;-41217956,78;90540000
Overførsel 2001877710010802255;VIPPS MOBILEPAY FILIAL AF;1,00;-41218106,78;90540000
Overførsel 2001330680010802259;VIPPS MOBILEPAY FILIAL AF;324,00;-41218291,78;90540000
Overførsel 2003444130010702256;VIPPS MOBILEPAY FILIAL AF;15,00;-41217941,78;90540000
Overførsel 2001877710010702258;VIPPS MOBILEPAY FILIAL AF;76,00;-41218107,78;90540000
Overførsel 2001330680010702252;VIPPS MOBILEPAY FILIAL AF;1593,00;-41218615,78;90540000
Overførsel 2000452160010702253;VIPPS MOBILEPAY FILIAL AF;990,10;-41220208,78;90540000
Overførsel 2000311450010702253;VIPPS MOBILEPAY FILIAL AF;15,84;-41221198,88;90540000
1804420041;AKSEL BIRCH JAKOBSEN;959,62;2974451,25;90541000
0909952433 - 2.halv;Enar Medzic;1924,19;2973491,63;90541000
Bgs 40915419, Thyvej 14,           2 rate;J.EDELGAARD HOLDING APS;1609,99;2977671,23;90541000
Bgs 40915419, Thyvej 14,           1 rate;J.EDELGAARD HOLDING APS;1609,99;2976061,24;90541000

